지끈거리는 두통을 무시하며 몸을 움직였다.
----------------@@@@@----------------------------------------------------------------
---------------@@@@@@@---------------------------------------------------------------
---------------@@@@@@@---------------------------------------------------------------
----------------@@@@@---------------------------------------------------------------
------------@@@@@@@@@@@@@@----------------------------------------------------------
-----------@@@@@@@@@@@@@@@@@@@------------------------------------------------------
-----------@@@@@@@@@@@@@@@@@@@@-----------------------------------------------------
-----------@@@@@@@@@@@@@@@@@@@@-----------------------------------------------------
-----------@@@@@@@@@@@@@@@@@@@@-----------------------------------------------------
-----------@@@@@@@@@@@@@@@@@@@------------------------------------------------------
-----------@@@@@@@@@@@@@@@@@@@------------------------------------------------------
----------@@@@@@@@@@@@@@@@@@@@@-----------------------------------------------------
------------@@@@@@@@@@@@@@@---------------------------------------------------------
------------@@@@@@@@@@@@@@@---------------------------------------------------------
------------@@@@@@@@@@@@@@@---------------------------------------------------------
------------@@@@@@@-@@@@@@@---------------------------------------------------------
------------@@@@@@@-@@@@@@@---------------------------------------------------------
------------@@@@@@@?@@@@@@@---------------------------------------------------------
------------@@@@@@@-@@@@@@@---------------------------------------------------------
------------@@@@@@@--@@@@@@---------------------------------------------------------
------------@@@@@@---@@@@@@@@@sssss-------------------------------------------------
-------------qq@@@@@sd-==-x@@@@@@@@ssss---------------------------------------------
-----------------WW@@@@@@@sss--DDDDDDDDDDDDDDDssssssss------------------------------
-----------------------PP@@@@@@@@@@--@@@@@@@@@@@@@@@@@@@@@@@@@@@@ssssss-------------
